69
8
#....................................................................
#....................................................................
#....................................................................
#....................................................................
#.......................####......................###................
#.................####.......................................#.......
#.........###..................................##......####.....#####
#################..............#######.....######......####.....#####
