139
8
#.........................................................................................................................................#
#.........................................................................................................................................#
#............................................#....#..######..................................##...........................................#
#............................................###.........................................##...............................................#
#.......................####......................###........#...........#............#....................#..###.........................#
#.................####................................................#......#..........................................................|.#
#.........###...........................#......##................####...............#....................#...........##..........#.....####
#################..............#######.....######.................................#................#..#...................#..#........#####
