139
8
#.........................................................................................................................................#
#......................................................%..................................................................................#
#............................................#....#..######..................................##...........................................#
#............................................###.........................................##....................%..........................#
#.......................####......................###........#...........#............#....................#..###.........................#
#.................####............................................%...#......#..........................................................|.#
#....%....###...........................#......##................####...............#....................#...........##..........#.....####
#################..............#######.....######.................................#................#..#...................#..#........#####
