70
8
#....................................................................#
#....................................................................#
#....................................................................#
#....................................................................#
#.......................####......................###................#
#.................####.......................................#.....|.#
#.........###...........................#......##......####.....######
#################..............#######.....######......####.....######
